adopt - усыновить
affairs - дела
amber - янтарь
ape - обезьяна
apprehension - опасение
assault - нападение
assure - гарантировать
awareness - осведомленность
badge - значок
bail - залог
beguiled - обманутый
bent - согнутый
bloated - раздутый
bloatedness - вздутие живота
bludgeon - принуждать
booze - выпивка
bulb - лампочка
cast out - изгнать
cease - прекратить
chiseled - точеный
claim - требовать
clarion - громкий звук
coasters - подставки
concern - беспокойство
conscience - совесть
consign - отправлять
counter - прилавок
creeps up - подкрадывается
curiosity - любопытство
dangle - свисать
daze - оцепенение
dazzling - ослепительный
decelerating - замедление
deluge - потоп
descend - спускаться
dimple - ямочка
discharge of - разрядка
disdain - презрение
dizzy - головокружительный
doubt - сомневаться
elaborate - разрабатывать
emblazoned - украшенный
enforcement - принуждение
etched on - выгравирован на
extinguish - погасить
faucet - водопроводный кран
fence - изгородь
fierce - яростный
fire up - зажечь
foreboding - дурное предчувствие
forehead - лоб
glance - взглянуть мельком
grain - зерно
grin - ухмылка
hang - висеть
hanged - повешенный
harbour - гавань
havoc - опустошение
honk - гудеть
hurl - швырять
imply - подразумевать
innocuous - безобидный
inordinate - непомерно
inspectorate - инспекция
interrogate - допросить
irreversible - необратимый
jaw - челюсть
lamentation - плач
lean on - опираться на
limbe - конечности
longing - тоска
lurid - зловещий
malt - солод
mane - грива
marinating - маринование
mercenary - наемник
mortise - паз
nod - кивок
oblivion - забвение
occupied - занят
ointment - мазь
ominous - зловещий
otherwise - иначе
perplexed - озадаченный
pile - куча
pluck - щипать
proceed - продолжить
profiteers - спекулянты
profound - глубокий
radiate - излучать
reassurance - успокаивание
rehearse - репетировать
remains - останки
renown - известность
resurface - всплывать
rigor - строгость
ripped off - сорвал
rub off - стереть
rum - ром
rumour - слух
scaffolding - строительные леса
scatterbrained - безрассудный
scion - отпрыск
scribble - каракули
shameful - постыдный
shrugs - пожимает плечами
silk - шелк
sinister - зловещий
sink - раковина
skua - поморник (вид птицы)
slender - стройный
slickness - гладкость
soaking - замачивание
sore - больной
sparkling - сверкающий
stain - пятно
stench - зловоние
struggle - борьба
stumble - спотыкаться
suffer - страдать
superstardom - суперзвезда
swirl - водоворот
swollenness - опухоль
swoon over - упасть в обморок
tattered - потрепанный
tenderness - нежность
to be up - быть в курсе
tremendous - огромный
uncaring towards - безразличный к
underneath - под
undignified - недостойный
unsteady - неустойчивый
upholstery - обивка
upstanding - честный
utterly - крайне
vague - нечеткий
vapour - пар
vast - огромный
vie - соперничать
virile - мужественный
voluntary - добровольный
wacky - чокнутый
weariness - усталость
wreak - вредить
wriggle - извиваться
